107
25
22 4  0  0  0  0  0  0  0  0  0  0  0  0  0  0  0  0  0  0  0  0  0  0  0  0  0  0  0  0  0  0  0  0  0  0  0  0  0  0  0  0  0  3  22 22 22 22 22 22 22 22 22 22 22 22 22 22 22 22 22 22 22 22 22 22 22 22 22 22 22 22 22 22 22 4  0  0  0  0  0  0  0  0  0  0  0  0  0  0  3  22 22 22 22 22 22 22 22 22 22 22 22 22 22 22 22
22 4  0  0  0  0  0  0  0  0  0  0  0  0  0  0  0  0  0  0  0  0  0  0  0  0  0  0  0  0  0  0  0  0  0  0  0  0  0  0  0  0  0  0  18 22 22 22 22 22 22 22 22 22 22 22 22 22 22 22 19 17 17 17 17 17 17 17 17 17 18 22 22 22 22 4  0  0  0  0  0  0  0  0  0  0  0  0  0  0  0  18 22 22 22 22 22 19 17 17 17 17 17 17 17 18 22
22 4  0  0  0  0  0  0  0  0  -1 0  0  0  0  0  0  0  0  0  0  0  0  0  0  0  22 0  0  0  0  22 0  0  0  0  0  0  0  0  0  0  0  3  22 22 22 22 22 22 22 22 22 22 22 22 22 22 22 22 22 22 22 22 22 22 22 22 22 22 22 22 22 22 22 4  0  0  0  0  0  0  0  0  0  0  0  0  0  42 3  22 22 22 22 22 22 22 22 22 22 22 22 22 22 22 22
22 4  0  0  0  0  0  0  0  0  0  0  0  0  0  0  0  0  14 22 0  0  0  0  0  0  22 0  0  0  0  22 0  0  0  0  0  0  0  0  0  0  0  0  18 22 22 22 22 22 22 22 22 22 22 22 22 22 22 22 19 17 17 17 17 17 17 17 17 17 18 22 22 22 22 4  0  0  0  0  0  0  0  0  0  0  0  0  0  0  0  18 22 22 22 22 22 19 17 17 17 17 17 17 17 18 22
22 4  0  0  0  0  0  0  0  0  0  0  0  0  0  0  0  0  0  22 0  0  0  0  0  0  22 0  0  0  0  22 0  0  0  0  0  0  0  0  0  0  0  3  22 22 22 22 22 22 22 22 22 22 22 22 22 22 22 22 22 22 22 22 22 22 22 22 22 22 22 22 22 22 22 4  0  0  0  0  0  0  0  0  0  0  0  0  0  0  3  22 22 22 22 22 22 22 22 22 22 22 22 22 22 22 22
22 4  0  0  0  0  0  0  0  0  0  0  -1 0  0  0  0  0  14 22 0  0  0  0  0  0  22 0  0  0  0  22 0  0  0  0  0  0  0  0  0  0  0  0  18 22 22 22 22 22 22 22 22 22 22 22 22 22 22 22 19 17 17 17 17 17 17 17 17 17 18 22 22 22 22 4  0  0  0  0  0  0  0  0  0  0  0  0  0  0  0  18 22 22 22 22 22 19 17 17 17 17 17 17 17 18 22
22 4  0  0  0  0  0  0  -1 0  0  0  13 0  0  22 22 22 22 22 0  0  0  0  0  0  22 0  0  0  0  22 0  0  0  0  0  0  0  0  10 0  0  0  0  17 17 17 18 22 22 22 22 22 22 22 22 22 22 22 4  0  0  16 0  0  0  0  0  0  0  17 18 22 22 4  0  0  0  0  0  0  0  0  0  0  0  0  0  0  0  0  18 22 22 22 22 4  0  0  0  0  0  0  0  18 22
22 4  0  0  0  0  0  0  0  0  0  0  0  0  0  22 0  0  22 22 0  0  0  0  0  0  22 0  0  0  0  22 0  0  0  0  0  0  0  23 24 25 0  0  0  0  0  0  0  17 17 18 22 22 22 22 22 22 22 19 0  0  10 0  11 0  0  0  0  0  0  0  0  17 17 0  0  0  0  9  0  0  0  0  1  21 2  0  0  0  0  0  0  18 22 22 22 4  0  0  0  0  0  0  0  18 22
22 4  0  0  0  12 0  0  0  0  0  0  0  0  21 22 0  0  22 22 0  0  0  0  0  0  22 0  0  0  0  22 0  0  0  0  0  0  0  0  0  0  0  0  0  9  11 0  0  0  0  0  17 17 17 17 17 17 17 0  0  1  21 21 21 2  0  0  0  0  0  0  0  0  0  0  0  0  0  23 24 25 0  0  3  22 4  0  0  0  0  0  0  0  18 22 22 4  0  0  0  0  0  0  0  18 22
22 4  0  0  0  0  0  0  0  0  0  21 21 21 6  22 0  0  22 22 0  0  10 9  0  0  22 42 0  0  0  22 0  0  0  0  0  0  0  0  0  0  0  0  0  21 21 21 2  0  0  0  9  0  0  0  0  9  0  0  0  3  22 22 22 4  0  0  0  0  0  0  0  0  0  0  0  0  0  0  0  0  0  0  3  22 4  0  0  0  0  0  0  0  0  17 17 0  0  0  0  0  0  0  0  18 22
22 4  0  0  0  0  0  0  0  0  0  0  0  0  0  22 0  0  22 22 1  21 21 21 0  22 22 22 0  0  22 22 22 0  0  0  0  0  0  0  0  0  0  3  22 22 22 22 4  10 0  1  21 2  0  0  1  21 2  11 1  21 6  22 22 4  0  0  0  0  0  0  0  9  0  0  10 9  0  0  11 0  0  1  21 5  21 2  0  0  0  0  0  0  0  0  0  0  0  0  0  0  0  0  0  18 22
22 24 24 24 24 24 24 24 24 24 24 24 24 24 24 25 0  23 24 24 24 24 24 24 24 24 24 24 25 0  24 24 24 24 24 24 24 24 24 24 24 24 24 24 24 24 24 24 24 24 24 24 24 24 24 24 24 24 24 24 24 24 24 24 24 24 24 24 24 24 24 24 24 24 24 24 24 24 24 24 24 24 24 24 24 24 24 24 24 24 24 24 24 24 24 24 24 24 24 24 24 24 25 0  0  18 22
22 4  0  0  0  0  0  0  0  0  0  0  0  0  0  0  0  0  0  0  0  0  0  0  0  0  0  3  22 4  0  0  0  0  0  0  0  0  3  22 4  0  0  0  3  22 4  0  0  0  0  0  0  0  0  0  0  0  0  0  0  0  0  0  0  0  0  0  0  0  0  0  0  0  0  0  0  0  0  0  0  0  0  0  0  0  0  0  0  0  0  0  0  0  0  0  0  0  0  0  0  0  0  0  0  18 22
22 4  0  0  0  0  0  0  0  0  0  0  0  0  0  0  0  0  0  0  0  0  0  0  0  0  0  3  22 4  0  0  0  0  0  0  0  0  3  22 4  0  0  0  3  22 4  0  0  0  0  0  0  0  0  0  0  0  0  0  0  0  0  0  0  0  0  0  0  0  0  0  0  0  0  0  0  0  0  0  0  0  0  0  0  0  0  0  0  0  0  0  0  0  0  0  0  0  0  0  0  0  0  0  0  18 22
22 4  0  0  0  0  0  0  0  0  0  0  0  0  0  0  0  0  0  0  0  0  0  0  0  0  0  -1 22 4  0  0  0  0  0  0  0  0  3  22 4  0  0  0  3  22 4  0  0  0  0  0  0  0  0  0  0  0  0  0  0  0  0  0  0  0  0  0  0  0  0  0  0  0  0  0  0  0  0  0  0  0  0  0  0  0  0  0  0  0  0  0  0  0  0  0  0  0  0  0  0  0  0  0  0  18 22
22 4  0  0  0  0  0  0  0  0  0  0  0  0  0  0  0  0  0  0  0  0  0  0  0  0  0  3  0  4  0  0  0  0  0  0  0  0  3  22 4  0  0  0  3  22 4  0  0  0  0  0  0  0  0  0  0  0  0  0  0  0  0  0  0  0  0  0  0  0  0  0  0  0  0  0  0  0  0  0  0  0  0  0  0  0  0  0  0  0  0  0  0  0  0  0  0  0  0  0  0  0  0  0  0  18 22
22 4  0  0  0  -9 0  0  0  0  0  0  0  0  0  0  0  0  0  0  0  0  0  0  0  0  0  3  0  4  0  0  0  0  0  0  0  0  3  22 4  0  0  0  3  22 4  0  0  0  63 0  0  0  0  0  0  0  0  0  0  0  0  0  0  0  0  0  0  0  0  0  0  0  0  0  0  0  0  0  0  0  0  0  0  0  0  0  0  0  0  0  0  0  0  0  0  0  0  0  0  0  0  0  0  18 22
22 4  0  0  0  0  0  0  0  0  0  0  0  0  0  0  0  0  0  0  0  0  0  0  0  0  0  3  0  4  0  0  0  0  0  0  0  0  3  22 4  0  0  0  3  22 4  0  0  0  0  0  0  0  0  0  0  0  0  0  0  0  0  0  0  0  0  0  0  0  0  0  0  0  0  0  0  0  0  0  0  0  0  0  0  0  0  0  0  0  0  0  0  0  0  0  0  0  0  0  0  0  0  0  0  18 22
22 4  0  0  0  0  0  0  0  0  0  0  0  0  0  63 0  0  0  0  0  0  0  0  3  22 4  3  22 4  63 0  0  0  0  0  0  0  23 24 25 0  0  0  0  23 25 0  0  0  0  0  0  0  0  0  0  0  0  0  0  0  0  0  0  0  0  0  0  0  0  0  0  0  0  0  0  0  0  0  0  0  0  0  0  0  0  0  0  0  0  0  0  0  0  0  0  0  0  0  0  0  0  0  0  18 22
22 4  0  0  0  0  0  0  0  0  23 24 25 0  0  0  0  0  0  0  0  0  0  0  0  23 24 24 25 0  0  0  0  0  0  0  0  0  0  0  0  0  0  0  0  0  0  0  0  0  0  0  0  0  0  0  0  0  0  0  0  0  0  0  0  0  0  0  0  0  0  0  0  0  0  0  0  0  0  0  0  9  0  0  0  0  0  0  0  0  0  0  0  0  0  0  0  0  0  0  0  0  0  0  0  18 22
22 4  0  0  0  0  0  0  0  0  0  0  0  0  0  0  0  0  0  0  0  0  0  0  0  0  0  0  0  43 43 0  0  0  0  0  0  0  0  0  0  0  0  0  0  9  0  0  0  0  0  0  0  0  0  0  0  0  0  0  0  0  0  0  0  0  0  0  0  0  0  0  0  0  0  0  0  0  0  0  0  0  0  0  0  0  0  0  0  0  0  0  0  0  0  0  0  0  0  0  0  0  0  0  0  18 22
22 4  0  0  0  0  0  0  0  0  0  0  0  0  23 24 25 0  0  0  0  0  0  0  0  0  0  0  0  0  0  0  0  0  0  0  0  0  0  0  0  0  0  0  0  0  0  0  0  0  0  0  0  0  0  0  0  0  0  0  0  0  0  0  0  0  0  0  0  0  0  0  0  0  0  0  0  0  0  0  0  0  0  0  0  0  0  0  0  0  0  0  0  0  0  0  0  0  0  0  0  0  0  0  0  18 22
24 24 24 24 24 24 24 24 25 0  0  0  0  0  0  0  0  0  0  0  0  0  0  0  0  0  23 25 0  0  0  0  23 24 0  0  0  0  0  0  -9 0  0  0  -9 0  0  0  -9 0  0  0  0  24 24 24 24 24 24 24 24 24 24 24 24 24 24 24 24 24 24 24 24 24 24 24 24 24 24 24 24 24 24 24 24 24 24 24 24 24 24 24 24 24 24 24 24 24 24 24 24 24 24 24 24 24 24
46 0  0  0  0  0  0  0  0  0  0  0  0  0  0  0  0  0  0  0  0  0  0  0  0  0  0  0  0  0  0  0  0  0  0  0  0  0  0  0  0  0  0  0  0  0  0  0  0  0  0  0  0  0  0  0  0  0  0  0  0  0  0  0  0  0  0  0  0  0  0  0  0  0  0  0  0  0  0  0  0  0  0  0  0  0  0  0  0  0  0  0  0  0  0  0  0  0  0  0  0  0  0  0  0  0  46
46 46 46 46 46 46 46 46 46 46 46 46 46 46 46 46 46 46 46 46 46 46 46 46 46 46 46 46 46 42 42 46 46 46 46 46 46 46 46 46 46 46 46 46 46 46 46 46 46 46 46 46 46 46 46 46 46 46 46 46 46 46 46 46 46 46 46 46 46 46 46 46 46 46 46 46 46 46 46 46 46 46 46 46 46 46 46 46 46 46 46 46 46 46 46 46 46 46 46 46 46 46 46 46 46 46 46







-1 - spawn enemy of type 1

3  - left decore for full-block wall
4  - right decore for full-block wall

22 - full block wall
23 - left corner from #24
24 - half block wall
25 - right corner from #24

46 - invisible killing blockpawn block

63 - save-block